###############
# # # # # # # #
#            p#
### ########### 
#            
# # # # # # # #
###############