###############
# # # # # # # #
#           p #
### ########### 
#            
# # # # # # # #
###############