###############
# # # # # # # #
#           c #
### ########### 
#            
# # # # # # # #
###############