###########################
#                         #
######################### #
#                         #
# #########################
#             p           #
######################### #
#                         #
# #########################
#                         #
######################### #
#                         #
###########################